 to|PRT visit|VERB you|PRON ?|.
 get|VERB some|DET sleep|NOUN tonight|NOUN ,|. okay|NOUN ?|.
 afraid|NOUN of|ADP the|DET dark|NOUN ,|. you|PRON know|VERB ?|.
 What|QUESTIONTAG are|VERB you|PRON up|ADP to|PRT this|DET weekend|NOUN ?|.
 your|PRON six|NUM o'clock|NOUN ?|.
 help|NOUN you|PRON --|. ?|.
 in|ADP a|DET goddamn|NOUN cell|NOUN ,|. dressed|VERB like|ADP this|DET ?|.
 way|NOUN relaxed|VERB ?|.
 school|NOUN just|ADV an|DET elaborate|ADJ dream|NOUN ?|.
 What|QUESTIONTAG ?|.
 this|DET pattern|NOUN of|ADP analysis|NOUN ,|. we|PRON 're|VERB about|ADP to|PRT discuss|VERB a|DET traumatic|ADJ event|NOUN that|DET rendered|VERB this|DET psychological|ADJ profile|NOUN useless|NOUN ,|. correct|VERB ?|.
 you|PRON tell|VERB me|PRON about|ADP him|PRON ?|.
 him|PRON that|DET night|NOUN ?|.
 your|PRON office|NOUN ,|. you|PRON were|VERB driving|VERB home|NOUN ,|. you|PRON got|VERB detoured|VERB by|ADP the|DET police|NOUN --|. Did|NOUN you|PRON call|VERB someone|NOUN on|ADP the|DET phone|NOUN that|DET night|NOUN ?|.
 night|NOUN ?|.
 marriage|NOUN ,|. was|VERB n't|ADV there|ADV ?|.
 wrong|ADJ with|ADP Doug|NOUN ?|.
 Is|VERB that|ADP number|NOUN three|NUM ?|.
 Hello|NOUN ?|.
 want|NOUN to|PRT speak|VERB to|PRT my|PRON lawyer|NOUN --|. wait|NOUN ,|. what|PRON are|VERB you|PRON doing|VERB ?|.
 all|DET I|PRON hear|VERB is|VERB nothing|NOUN gets|VERB past|ADP you|PRON ,|. I|PRON mean|VERB ,|. that|DET 's|VERB just|ADV hearsay|ADJ and|CONJ I|PRON do|VERB n't|ADV pay|VERB much|ADJ attention|NOUN to|PRT hearsay|VERB because|ADV now|ADV they|PRON say|VERB you|PRON hacked|VERB your|PRON husband|NOUN with|ADP an|DET axe|NOUN but|CONJ I|PRON say|VERB maybe|ADV it|PRON just|ADV slipped|VERB ,|. right|ADV ?|.
 I|PRON see|VERB you|PRON that|ADP night|NOUN ?|.
 up|ADV here|ADV ?|.
 suspects|NOUN in|ADP anyone|NOUN 's|PRT mind|NOUN ?|.
 can|VERB pretend|VERB that|DET did|VERB n't|ADV just|ADV happen|VERB ?|.
 Could|VERB a|DET specific|ADJ epileptic|ADJ element|NOUN be|VERB involved|VERB ?|.
 hearing|NOUN ?|.
 locked|VERB ,|. what|PRON else|ADV could|VERB they|PRON say|VERB ?|.
 claim|NOUN ?|.
 killed|VERB herself|PRON ?|.
 hospital|NOUN records|NOUN and|CONJ so|ADV forth|ADV ?|.
 First|ADV I|PRON 'm|VERB a|DET suspect|NOUN in|ADP Doug|NOUN 's|PRT death|NOUN ,|. now|ADV what|PRON ,|. Phil|NOUN Parsons|NOUN murdered|VERB his|PRON own|ADJ daughter|NOUN ?|.
 fact|NOUN ,|. how|ADV is|VERB anybody|ADJ sure|ADJ these|DET were|VERB suicides|NOUN ?|.
 investigative|ADJ reporter|NOUN who|PRON connected|VERB three|NUM highly-suspicious|ADJ deaths|NOUN ,|. just|ADV happens|VERB to|PRT have|VERB conveniently|ADV died|VERB ?|.
 service|NOUN ?|.
 'motherfucker|NOUN '|. ?|.
 the|DET coffee|NOUN --|. ?|.
 the|DET suspect|NOUN ?|.
 things|NOUN ,|. did|VERB n't|ADV she|PRON ?|.
 she|PRON knew|VERB what|PRON her|PRON husband|NOUN was|VERB doing|VERB to|PRT those|DET girls|NOUN ?|.
 she|PRON ?|.
 open|ADJ so|ADP I|PRON 'd|VERB try|VERB and|CONJ run|VERB ,|. it|PRON 's|VERB what|PRON you|PRON get|VERB off|ADP on|ADP ,|. is|VERB n't|ADV it|PRON ?|.
 Help|NOUN you|PRON ,|. gentlemen|NOUN ?|.