 ...|. this|DET way|NOUN --|. ?|.
 the|DET other|ADJ enlisted|ADJ personnel|NOUN ?|.
 You|PRON need|VERB money|NOUN --|. ?|.
 What|QUESTIONTAG do|VERB I|PRON owe|VERB you|PRON ?|.
 Before|ADP we|PRON get|VERB started|VERB ,|. I|PRON 'm|VERB dying|VERB to|PRT know|VERB :|. which|DET genius|VERB here|ADV hatched|VERB the|DET scheme|NOUN of|ADP pairing|VERB a|DET Sound|NOUN Bite|NOUN from|ADP Nebraska|NOUN with|ADP a|DET relic|NOUN who|PRON thinks|VERB keeping|VERB suicide|ADJ bombers|NOUN off|ADP our|PRON busses|NOUN is|VERB unconstitutional|ADJ ?|.
 many|ADJ votes|NOUN ?|.
 Did|NOUN we|PRON come|VERB here|ADV to|PRT have|VERB a|DET discussion|NOUN ?|.
 casualties|NOUN ?|.
 girl|NOUN since|ADP we|PRON ...|. stopped|VERB seeing|VERB each|DET other|ADJ --|. does|VERB n't|ADV that|DET say|VERB something|NOUN to|PRT you|PRON ?|.
 before|ADP ,|. yes|X ?|.
 Dontcha|NOUN love|VERB this|DET guy|NOUN ?|.
 Sergeant|ADJ Shaw|NOUN ?|.
 Is|VERB this|DET seat|NOUN taken|VERB ?|.
 you|PRON somewhere|ADV ?|.
 freshened|VERB up|PRT ?|.
 Ben|NOUN ?|.
 there|ADV ?|.
 (|. then|ADV )|. How|QUESTIONTAG 'd|VERB you|PRON find|VERB me|PRON ?|.
 What|QUESTIONTAG if|ADP all|DET this|DET is|VERB the|DET fucking|ADJ dream|NOUN and|CONJ you|PRON 're|VERB still|ADV back|ADV in|ADP Kuwait|NOUN ?|.
 Arthur|NOUN oppose|VERB deploying|VERB troops|NOUN in|ADP Indonesia|NOUN ?|.
 (|. to|PRT Marco|NOUN )|. What|QUESTIONTAG do|VERB you|PRON want|VERB from|ADP me|PRON ,|. Captain|NOUN ?|.
 happened|VERB ?|.
 Which|QUESTIONTAG ?|.
 little|ADJ discrepancy|NOUN ?|.
 ``|. buddies|NOUN ,|. ''|. who|PRON love|VERB and|CONJ adore|VERB me|PRON for|ADP saving|VERB their|PRON pathetically|NOUN unimportant|ADJ --|. present|ADJ company|NOUN excluded|VERB --|. asses|NOUN ?|.
 Does|VERB n't|ADV it|PRON look|VERB yummy|PRON ?|.
 food|NOUN could|VERB there|VERB possibly|ADV be|VERB a|DET more|ADV vulgar|ADJ dish|NOUN ?|.
 an|DET oxymoron|NOUN ?|.
 What|QUESTIONTAG else|ADV did|VERB we|PRON talk|VERB about|ADP ?|.
 to|PRT me|PRON ?|.
 everything|NOUN we|PRON 've|VERB worked|VERB toward|ADP ,|. and|CONJ every|DET one|NUM of|ADP us|PRON along|ADP with|ADP it|PRON ,|. and|CONJ you|PRON want|VERB me|PRON to|PRT call|VERB a|DET meeting|NOUN ?|.
 Private|ADJ Baker|NOUN so|ADP we|PRON can|VERB move|VERB on|ADP ?|.